100|100|100|100|100|100|100|100|100|100|100|100|100|100|100|100|100|100|100|100
-------------------------------------------------------------------------------
100|100|100|100|100|100|100|100|100|100|100|100|100|100|100|100|100|100|100|100
-------------------------------------------------------------------------------
100|100|100|100|100|100|100|100|100|100|100|100|100|100|100|100|100|100|100|100
-------------------------------------------------------------------------------
100|100|100|100|100|100|100|100|100|100|100|100|100|100|100|100|100|100|100|100
-------------------------------------------------------------------------------
100|100|100|100|100|100|100|100|100|100|100|100|100|100|112|100|100|100|100|100
-------------------------------------------------------------------------------
100|100|100|100|100|100|100|100|100|100|100|100|100|100|132|112|100|100|100|100
-------------------------------------------------------------------------------
100|100|100|100|400|400|400|400|100|100|200|100|100|100|100|100|112|100|100|100
-------------------------------------------------------------------------------
100|100|100|100|200|400|400|321|100|100|200|100|100|100|100|100|100|100|100|100
-------------------------------------------------------------------------------
100|100|100|100|200|200|400|131|100|100|100|111|100|100|100|100|100|100|100|100
-------------------------------------------------------------------------------
100|100|100|100|100|100|100|100|100|100|100|321|100|131|100|100|100|100|100|100
-------------------------------------------------------------------------------
100|100|100|100|100|112|100|100|100|100|100|111|100|400|100|100|100|100|100|100
-------------------------------------------------------------------------------
100|100|100|100|100|100|200|200|400|132|100|100|400|400|100|100|100|100|100|100
-------------------------------------------------------------------------------
100|100|100|100|100|100|100|200|200|112|100|200|400|400|400|100|100|100|100|100
-------------------------------------------------------------------------------
100|100|100|100|100|100|100|100|100|100|100|200|200|400|400|100|100|100|100|100
-------------------------------------------------------------------------------
100|100|100|100|100|100|100|100|100|100|100|100|100|100|100|100|100|100|100|100
-------------------------------------------------------------------------------
100|100|100|100|100|100|100|100|100|100|100|100|100|100|100|100|100|100|100|100
-------------------------------------------------------------------------------
100|100|100|100|100|100|100|100|100|100|100|100|100|100|100|100|100|100|100|100
-------------------------------------------------------------------------------
100|100|100|100|100|100|100|100|100|100|100|100|100|100|100|100|100|100|100|100
-------------------------------------------------------------------------------
100|100|100|100|100|100|100|100|100|100|100|100|100|100|100|100|100|100|100|100
-------------------------------------------------------------------------------
100|100|100|100|100|100|100|100|100|100|100|100|100|100|100|100|100|100|100|100
-------------------------------------------------------------------------------